DATA	aiwars.py
PLAYERS	2
SIZE	10	10
TILES
0 0 0 0 0 0 0 0 0 0
0 1 1 1 0 0 0 0 0 0
0 0 1 1 0 0 0 0 1 1
0 1 1 1 0 1 1 0 0 0
0 0 1 1 0 1 1 1 0 0
0 1 1 1 0 0 1 0 0 0
0 0 1 1 0 1 0 0 0 0
0 1 1 1 1 0 0 0 0 0
0 0 1 0 1 1 1 1 0 0
0 1 0 0 1 0 0 0 0 0
NEUTRAL
0	1	1
0	8	1
0	2	2
0	7	2
PLAYER 1
2	1	4
PLAYER 2
2	8	5